Año,Trimestre,Provincia,Banda ancha fija,Dial up,Total,Proporción,Crecimiento Trimestral,Crecimiento Anual,Trimestre2
2014,1,Buenos Aires,2725732,14144,2739876,0.4282,0.00,0.00,2014-01-01
2014,1,Capital Federal,1289204,10714,1299918,0.2032,0.00,0.00,2014-01-01
2014,1,Catamarca,24209,23,24232,0.0038,0.00,0.00,2014-01-01
2014,1,Chaco,62520,36,62556,0.0098,0.00,0.00,2014-01-01
2014,1,Chubut,68205,2016,70221,0.0110,0.00,0.00,2014-01-01
2014,1,Corrientes,62203,33,62236,0.0097,0.00,0.00,2014-01-01
2014,1,Córdoba,566705,205,566910,0.0886,0.00,0.00,2014-01-01
2014,1,Entre Ríos,134216,115,134331,0.0210,0.00,0.00,2014-01-01
2014,1,Formosa,25335,87,25422,0.0040,0.00,0.00,2014-01-01
2014,1,Jujuy,33825,2,33827,0.0053,0.00,0.00,2014-01-01
2014,1,La Pampa,53601,592,54193,0.0085,0.00,0.00,2014-01-01
2014,1,La Rioja,15688,23,15711,0.0025,0.00,0.00,2014-01-01
2014,1,Mendoza,164084,1761,165845,0.0259,0.00,0.00,2014-01-01
2014,1,Misiones,73950,0,73950,0.0116,0.00,0.00,2014-01-01
2014,1,Neuquén,88077,2303,90380,0.0141,0.00,0.00,2014-01-01
2014,1,Río Negro,93909,1157,95066,0.0149,0.00,0.00,2014-01-01
2014,1,Salta,91265,25,91290,0.0143,0.00,0.00,2014-01-01
2014,1,San Juan,50543,755,51298,0.0080,0.00,0.00,2014-01-01
2014,1,San Luis,12193,364,12557,0.0020,0.00,0.00,2014-01-01
2014,1,Santa Cruz,26304,460,26764,0.0042,0.00,0.00,2014-01-01
2014,1,Santa Fe,506000,612,506612,0.0792,0.00,0.00,2014-01-01
2014,1,Santiago Del Estero,37124,9,37133,0.0058,0.00,0.00,2014-01-01
2014,1,Tierra Del Fuego,27272,766,28038,0.0044,0.00,0.00,2014-01-01
2014,1,Tucumán,129944,88,130032,0.0203,0.00,0.00,2014-01-01
2014,2,Buenos Aires,2750430,14116,2764546,0.4277,0.90,0.00,2014-04-01
2014,2,Capital Federal,1299502,10713,1310215,0.2027,0.79,0.00,2014-04-01
2014,2,Catamarca,24660,23,24683,0.0038,1.86,0.00,2014-04-01
2014,2,Chaco,63243,36,63279,0.0098,1.16,0.00,2014-04-01
2014,2,Chubut,68503,2016,70519,0.0109,0.42,0.00,2014-04-01
2014,2,Corrientes,62925,33,62958,0.0097,1.16,0.00,2014-04-01
2014,2,Córdoba,576747,205,576952,0.0892,1.77,0.00,2014-04-01
2014,2,Entre Ríos,135468,115,135583,0.0210,0.93,0.00,2014-04-01
2014,2,Formosa,25535,65,25600,0.0040,0.70,0.00,2014-04-01
2014,2,Jujuy,34359,2,34361,0.0053,1.58,0.00,2014-04-01
2014,2,La Pampa,55048,580,55628,0.0086,2.65,0.00,2014-04-01
2014,2,La Rioja,15889,23,15912,0.0025,1.28,0.00,2014-04-01
2014,2,Mendoza,165046,1761,166807,0.0258,0.58,0.00,2014-04-01
2014,2,Misiones,74689,0,74689,0.0116,1.00,0.00,2014-04-01
2014,2,Neuquén,90053,2235,92288,0.0143,2.11,0.00,2014-04-01
2014,2,Río Negro,94812,1145,95957,0.0148,0.94,0.00,2014-04-01
2014,2,Salta,91949,25,91974,0.0142,0.75,0.00,2014-04-01
2014,2,San Juan,50891,755,51646,0.0080,0.68,0.00,2014-04-01
2014,2,San Luis,12691,364,13055,0.0020,3.97,0.00,2014-04-01
2014,2,Santa Cruz,26710,459,27169,0.0042,1.51,0.00,2014-04-01
2014,2,Santa Fe,511753,605,512358,0.0793,1.13,0.00,2014-04-01
2014,2,Santiago Del Estero,38002,9,38011,0.0059,2.36,0.00,2014-04-01
2014,2,Tierra Del Fuego,27443,766,28209,0.0044,0.61,0.00,2014-04-01
2014,2,Tucumán,131981,88,132069,0.0204,1.57,0.00,2014-04-01
2014,3,Buenos Aires,2835537,14028,2849565,0.4321,3.08,0.00,2014-07-01
2014,3,Capital Federal,1307195,10630,1317825,0.1998,0.58,0.00,2014-07-01
2014,3,Catamarca,24665,21,24686,0.0037,0.01,0.00,2014-07-01
2014,3,Chaco,63710,36,63746,0.0097,0.74,0.00,2014-07-01
2014,3,Chubut,67130,2007,69137,0.0105,-1.96,0.00,2014-07-01
2014,3,Corrientes,63516,33,63549,0.0096,0.94,0.00,2014-07-01
2014,3,Córdoba,585231,200,585431,0.0888,1.47,0.00,2014-07-01
2014,3,Entre Ríos,136618,115,136733,0.0207,0.85,0.00,2014-07-01
2014,3,Formosa,25873,64,25937,0.0039,1.32,0.00,2014-07-01
2014,3,Jujuy,33739,2,33741,0.0051,-1.80,0.00,2014-07-01
2014,3,La Pampa,61861,564,62425,0.0095,12.22,0.00,2014-07-01
2014,3,La Rioja,15893,23,15916,0.0024,0.03,0.00,2014-07-01
2014,3,Mendoza,166184,1740,167924,0.0255,0.67,0.00,2014-07-01
2014,3,Misiones,75327,0,75327,0.0114,0.85,0.00,2014-07-01
2014,3,Neuquén,100099,2268,102367,0.0155,10.92,0.00,2014-07-01
2014,3,Río Negro,96629,1151,97780,0.0148,1.90,0.00,2014-07-01
2014,3,Salta,92929,25,92954,0.0141,1.07,0.00,2014-07-01
2014,3,San Juan,51031,748,51779,0.0079,0.26,0.00,2014-07-01
2014,3,San Luis,12683,363,13046,0.0020,-0.07,0.00,2014-07-01
2014,3,Santa Cruz,25664,446,26110,0.0040,-3.90,0.00,2014-07-01
2014,3,Santa Fe,520196,691,520887,0.0790,1.66,0.00,2014-07-01
2014,3,Santiago Del Estero,37539,9,37548,0.0057,-1.22,0.00,2014-07-01
2014,3,Tierra Del Fuego,28037,755,28792,0.0044,2.07,0.00,2014-07-01
2014,3,Tucumán,131978,88,132066,0.0200,-0.00,0.00,2014-07-01
2014,4,Buenos Aires,2801178,15229,2816407,0.4268,-1.16,0.00,2014-10-01
2014,4,Capital Federal,1318526,11994,1330520,0.2016,0.96,0.00,2014-10-01
2014,4,Catamarca,25472,21,25493,0.0039,3.27,0.00,2014-10-01
2014,4,Chaco,65998,37,66035,0.0100,3.59,0.00,2014-10-01
2014,4,Chubut,66557,1985,68542,0.0104,-0.86,0.00,2014-10-01
2014,4,Corrientes,65656,54,65710,0.0100,3.40,0.00,2014-10-01
2014,4,Córdoba,590113,319,590432,0.0895,0.85,0.00,2014-10-01
2014,4,Entre Ríos,140567,246,140813,0.0213,2.98,0.00,2014-10-01
2014,4,Formosa,26156,51,26207,0.0040,1.04,0.00,2014-10-01
2014,4,Jujuy,35999,3,36002,0.0055,6.70,0.00,2014-10-01
2014,4,La Pampa,56813,567,57380,0.0087,-8.08,0.00,2014-10-01
2014,4,La Rioja,16379,23,16402,0.0025,3.05,0.00,2014-10-01
2014,4,Mendoza,167766,1848,169614,0.0257,1.01,0.00,2014-10-01
2014,4,Misiones,77222,7,77229,0.0117,2.52,0.00,2014-10-01
2014,4,Neuquén,92999,2397,95396,0.0145,-6.81,0.00,2014-10-01
2014,4,Río Negro,95050,1210,96260,0.0146,-1.55,0.00,2014-10-01
2014,4,Salta,93921,26,93947,0.0142,1.07,0.00,2014-10-01
2014,4,San Juan,51390,729,52119,0.0079,0.66,0.00,2014-10-01
2014,4,San Luis,12788,359,13147,0.0020,0.77,0.00,2014-10-01
2014,4,Santa Cruz,25277,436,25713,0.0039,-1.52,0.00,2014-10-01
2014,4,Santa Fe,528459,938,529397,0.0802,1.63,0.00,2014-10-01
2014,4,Santiago Del Estero,39308,9,39317,0.0060,4.71,0.00,2014-10-01
2014,4,Tierra Del Fuego,28249,741,28990,0.0044,0.69,0.00,2014-10-01
2014,4,Tucumán,137329,95,137424,0.0208,4.06,0.00,2014-10-01
2015,1,Buenos Aires,2847076,14766,2861842,0.4247,1.61,4.45,2015-01-01
2015,1,Capital Federal,1321139,11582,1332721,0.1978,0.17,2.52,2015-01-01
2015,1,Catamarca,25312,20,25332,0.0038,-0.63,4.54,2015-01-01
2015,1,Chaco,81329,31,81360,0.0121,23.21,30.06,2015-01-01
2015,1,Chubut,63327,1946,65273,0.0097,-4.77,-7.05,2015-01-01
2015,1,Corrientes,81488,43,81531,0.0121,24.08,31.00,2015-01-01
2015,1,Córdoba,596663,294,596957,0.0886,1.11,5.30,2015-01-01
2015,1,Entre Ríos,165839,231,166070,0.0246,17.94,23.63,2015-01-01
2015,1,Formosa,26657,43,26700,0.0040,1.88,5.03,2015-01-01
2015,1,Jujuy,36608,3,36611,0.0054,1.69,8.23,2015-01-01
2015,1,La Pampa,62155,542,62697,0.0093,9.27,15.69,2015-01-01
2015,1,La Rioja,16310,23,16333,0.0024,-0.42,3.96,2015-01-01
2015,1,Mendoza,168355,1805,170160,0.0253,0.32,2.60,2015-01-01
2015,1,Misiones,85139,7,85146,0.0126,10.25,15.14,2015-01-01
2015,1,Neuquén,93373,2369,95742,0.0142,0.36,5.93,2015-01-01
2015,1,Río Negro,96145,1188,97333,0.0144,1.11,2.38,2015-01-01
2015,1,Salta,96793,18,96811,0.0144,3.05,6.05,2015-01-01
2015,1,San Juan,51117,702,51819,0.0077,-0.58,1.02,2015-01-01
2015,1,San Luis,12878,354,13232,0.0020,0.65,5.38,2015-01-01
2015,1,Santa Cruz,26217,424,26641,0.0040,3.61,-0.46,2015-01-01
2015,1,Santa Fe,535640,797,536437,0.0796,1.33,5.89,2015-01-01
2015,1,Santiago Del Estero,39244,8,39252,0.0058,-0.17,5.71,2015-01-01
2015,1,Tierra Del Fuego,32726,730,33456,0.0050,15.41,19.32,2015-01-01
2015,1,Tucumán,138184,92,138276,0.0205,0.62,6.34,2015-01-01
2015,2,Buenos Aires,2871079,12711,2883790,0.4231,0.77,4.31,2015-04-01
2015,2,Capital Federal,1336391,9893,1346284,0.1975,1.02,2.75,2015-04-01
2015,2,Catamarca,25666,13,25679,0.0038,1.37,4.04,2015-04-01
2015,2,Chaco,83832,16,83848,0.0123,3.06,32.51,2015-04-01
2015,2,Chubut,61745,1740,63485,0.0093,-2.74,-9.97,2015-04-01
2015,2,Corrientes,83288,28,83316,0.0122,2.19,32.34,2015-04-01
2015,2,Córdoba,609510,236,609746,0.0895,2.14,5.68,2015-04-01
2015,2,Entre Ríos,169309,183,169492,0.0249,2.06,25.01,2015-04-01
2015,2,Formosa,27013,37,27050,0.0040,1.31,5.66,2015-04-01
2015,2,Jujuy,37720,2,37722,0.0055,3.03,9.78,2015-04-01
2015,2,La Pampa,63552,500,64052,0.0094,2.16,15.14,2015-04-01
2015,2,La Rioja,16491,18,16509,0.0024,1.08,3.75,2015-04-01
2015,2,Mendoza,169259,1564,170823,0.0251,0.39,2.41,2015-04-01
2015,2,Misiones,88512,7,88519,0.0130,3.96,18.52,2015-04-01
2015,2,Neuquén,95644,2241,97885,0.0144,2.24,6.06,2015-04-01
2015,2,Río Negro,97640,1087,98727,0.0145,1.43,2.89,2015-04-01
2015,2,Salta,98264,3,98267,0.0144,1.50,6.84,2015-04-01
2015,2,San Juan,51367,621,51988,0.0076,0.33,0.66,2015-04-01
2015,2,San Luis,12904,317,13221,0.0019,-0.08,1.27,2015-04-01
2015,2,Santa Cruz,25384,379,25763,0.0038,-3.30,-5.18,2015-04-01
2015,2,Santa Fe,545739,649,546388,0.0802,1.86,6.64,2015-04-01
2015,2,Santiago Del Estero,39375,3,39378,0.0058,0.32,3.60,2015-04-01
2015,2,Tierra Del Fuego,32960,619,33579,0.0049,0.37,19.04,2015-04-01
2015,2,Tucumán,140635,42,140677,0.0206,1.74,6.52,2015-04-01
2015,3,Buenos Aires,2916070,12695,2928765,0.4223,1.56,2.78,2015-07-01
2015,3,Capital Federal,1362193,9875,1372068,0.1978,1.92,4.12,2015-07-01
2015,3,Catamarca,26080,13,26093,0.0038,1.61,5.70,2015-07-01
2015,3,Chaco,85354,16,85370,0.0123,1.82,33.92,2015-07-01
2015,3,Chubut,62143,1740,63883,0.0092,0.63,-7.60,2015-07-01
2015,3,Corrientes,84931,28,84959,0.0123,1.97,33.69,2015-07-01
2015,3,Córdoba,622761,237,622998,0.0898,2.17,6.42,2015-07-01
2015,3,Entre Ríos,172252,182,172434,0.0249,1.74,26.11,2015-07-01
2015,3,Formosa,27751,1,27752,0.0040,2.60,7.00,2015-07-01
2015,3,Jujuy,39548,2,39550,0.0057,4.85,17.22,2015-07-01
2015,3,La Pampa,64976,495,65471,0.0094,2.22,4.88,2015-07-01
2015,3,La Rioja,16753,18,16771,0.0024,1.59,5.37,2015-07-01
2015,3,Mendoza,169261,1562,170823,0.0246,0.00,1.73,2015-07-01
2015,3,Misiones,91615,7,91622,0.0132,3.51,21.63,2015-07-01
2015,3,Neuquén,98376,2240,100616,0.0145,2.79,-1.71,2015-07-01
2015,3,Río Negro,98529,1085,99614,0.0144,0.90,1.88,2015-07-01
2015,3,Salta,100570,3,100573,0.0145,2.35,8.20,2015-07-01
2015,3,San Juan,51409,621,52030,0.0075,0.08,0.48,2015-07-01
2015,3,San Luis,12902,317,13219,0.0019,-0.02,1.33,2015-07-01
2015,3,Santa Cruz,25912,359,26271,0.0038,1.97,0.62,2015-07-01
2015,3,Santa Fe,556097,641,556738,0.0803,1.89,6.88,2015-07-01
2015,3,Santiago Del Estero,39394,3,39397,0.0057,0.05,4.92,2015-07-01
2015,3,Tierra Del Fuego,33118,619,33737,0.0049,0.47,17.17,2015-07-01
2015,3,Tucumán,144272,42,144314,0.0208,2.59,9.27,2015-07-01
2015,4,Buenos Aires,2946743,12642,2959385,0.4237,1.05,5.08,2015-10-01
2015,4,Capital Federal,1360381,9845,1370226,0.1962,-0.13,2.98,2015-10-01
2015,4,Catamarca,26459,13,26472,0.0038,1.45,3.84,2015-10-01
2015,4,Chaco,86537,16,86553,0.0124,1.39,31.07,2015-10-01
2015,4,Chubut,62279,1740,64019,0.0092,0.21,-6.60,2015-10-01
2015,4,Corrientes,85409,26,85435,0.0122,0.56,30.02,2015-10-01
2015,4,Córdoba,625835,235,626070,0.0896,0.49,6.04,2015-10-01
2015,4,Entre Ríos,173957,180,174137,0.0249,0.99,23.67,2015-10-01
2015,4,Formosa,28088,1,28089,0.0040,1.21,7.18,2015-10-01
2015,4,Jujuy,39922,2,39924,0.0057,0.95,10.89,2015-10-01
2015,4,La Pampa,66054,312,66366,0.0095,1.37,15.66,2015-10-01
2015,4,La Rioja,16914,18,16932,0.0024,0.96,3.23,2015-10-01
2015,4,Mendoza,169251,1556,170807,0.0245,-0.01,0.70,2015-10-01
2015,4,Misiones,92846,7,92853,0.0133,1.34,20.23,2015-10-01
2015,4,Neuquén,105122,2294,107416,0.0154,6.76,12.60,2015-10-01
2015,4,Río Negro,98655,1067,99722,0.0143,0.11,3.60,2015-10-01
2015,4,Salta,101917,3,101920,0.0146,1.34,8.49,2015-10-01
2015,4,San Juan,51408,621,52029,0.0074,-0.00,-0.17,2015-10-01
2015,4,San Luis,12901,317,13218,0.0019,-0.01,0.54,2015-10-01
2015,4,Santa Cruz,26047,356,26403,0.0038,0.50,2.68,2015-10-01
2015,4,Santa Fe,561045,627,561672,0.0804,0.89,6.10,2015-10-01
2015,4,Santiago Del Estero,39132,3,39135,0.0056,-0.67,-0.46,2015-10-01
2015,4,Tierra Del Fuego,29334,619,29953,0.0043,-11.22,3.32,2015-10-01
2015,4,Tucumán,146053,42,146095,0.0209,1.23,6.31,2015-10-01
2016,1,Buenos Aires,2929903,12612,2942515,0.4260,-0.57,2.82,2016-01-01
2016,1,Capital Federal,1328079,9817,1337896,0.1937,-2.36,0.39,2016-01-01
2016,1,Catamarca,26376,13,26389,0.0038,-0.31,4.17,2016-01-01
2016,1,Chaco,86635,16,86651,0.0125,0.11,6.50,2016-01-01
2016,1,Chubut,62060,1740,63800,0.0092,-0.34,-2.26,2016-01-01
2016,1,Corrientes,85510,26,85536,0.0124,0.12,4.91,2016-01-01
2016,1,Córdoba,609692,234,609926,0.0883,-2.58,2.17,2016-01-01
2016,1,Entre Ríos,174634,179,174813,0.0253,0.39,5.26,2016-01-01
2016,1,Formosa,28313,1,28314,0.0041,0.80,6.04,2016-01-01
2016,1,Jujuy,40287,2,40289,0.0058,0.91,10.05,2016-01-01
2016,1,La Pampa,65442,487,65929,0.0095,-0.66,5.15,2016-01-01
2016,1,La Rioja,16673,18,16691,0.0024,-1.42,2.19,2016-01-01
2016,1,Mendoza,169257,1553,170810,0.0247,0.00,0.38,2016-01-01
2016,1,Misiones,92951,7,92958,0.0135,0.11,9.17,2016-01-01
2016,1,Neuquén,101969,2292,104261,0.0151,-2.94,8.90,2016-01-01
2016,1,Río Negro,98745,1077,99822,0.0145,0.10,2.56,2016-01-01
2016,1,Salta,102423,3,102426,0.0148,0.50,5.80,2016-01-01
2016,1,San Juan,51373,621,51994,0.0075,-0.07,0.34,2016-01-01
2016,1,San Luis,12915,317,13232,0.0019,0.11,0.00,2016-01-01
2016,1,Santa Cruz,25931,356,26287,0.0038,-0.44,-1.33,2016-01-01
2016,1,Santa Fe,551378,618,551996,0.0799,-1.72,2.90,2016-01-01
2016,1,Santiago Del Estero,37695,3,37698,0.0055,-3.67,-3.96,2016-01-01
2016,1,Tierra Del Fuego,29867,619,30486,0.0044,1.78,-8.88,2016-01-01
2016,1,Tucumán,146596,41,146637,0.0212,0.37,6.05,2016-01-01
2016,2,Buenos Aires,3032776,12515,3045291,0.4271,3.49,5.60,2016-04-01
2016,2,Capital Federal,1384824,9760,1394584,0.1956,4.24,3.59,2016-04-01
2016,2,Catamarca,26543,13,26556,0.0037,0.63,3.42,2016-04-01
2016,2,Chaco,88235,16,88251,0.0124,1.85,5.25,2016-04-01
2016,2,Chubut,62116,1740,63856,0.0090,0.09,0.58,2016-04-01
2016,2,Corrientes,86932,24,86956,0.0122,1.66,4.37,2016-04-01
2016,2,Córdoba,634680,234,634914,0.0890,4.10,4.13,2016-04-01
2016,2,Entre Ríos,178194,179,178373,0.0250,2.04,5.24,2016-04-01
2016,2,Formosa,28801,1,28802,0.0040,1.72,6.48,2016-04-01
2016,2,Jujuy,41187,2,41189,0.0058,2.23,9.19,2016-04-01
2016,2,La Pampa,68403,485,68888,0.0097,4.49,7.55,2016-04-01
2016,2,La Rioja,16718,18,16736,0.0023,0.27,1.38,2016-04-01
2016,2,Mendoza,169274,1550,170824,0.0240,0.01,0.00,2016-04-01
2016,2,Misiones,95808,7,95815,0.0134,3.07,8.24,2016-04-01
2016,2,Neuquén,108224,2291,110515,0.0155,6.00,12.90,2016-04-01
2016,2,Río Negro,99631,1073,100704,0.0141,0.88,2.00,2016-04-01
2016,2,Salta,104929,3,104932,0.0147,2.45,6.78,2016-04-01
2016,2,San Juan,51392,621,52013,0.0073,0.04,0.05,2016-04-01
2016,2,San Luis,12939,317,13256,0.0019,0.18,0.26,2016-04-01
2016,2,Santa Cruz,25797,356,26153,0.0037,-0.51,1.51,2016-04-01
2016,2,Santa Fe,563867,607,564474,0.0792,2.26,3.31,2016-04-01
2016,2,Santiago Del Estero,36958,3,36961,0.0052,-1.96,-6.14,2016-04-01
2016,2,Tierra Del Fuego,30740,619,31359,0.0044,2.86,-6.61,2016-04-01
2016,2,Tucumán,148636,41,148677,0.0209,1.39,5.69,2016-04-01
2016,3,Buenos Aires,3075387,11205,3086592,0.4283,1.36,5.39,2016-07-01
2016,3,Capital Federal,1395053,8051,1403104,0.1947,0.61,2.26,2016-07-01
2016,3,Catamarca,26957,13,26970,0.0037,1.56,3.36,2016-07-01
2016,3,Chaco,89216,14,89230,0.0124,1.11,4.52,2016-07-01
2016,3,Chubut,62222,1730,63952,0.0089,0.15,0.11,2016-07-01
2016,3,Corrientes,88328,12,88340,0.0123,1.59,3.98,2016-07-01
2016,3,Córdoba,642458,133,642591,0.0892,1.21,3.14,2016-07-01
2016,3,Entre Ríos,181092,57,181149,0.0251,1.56,5.05,2016-07-01
2016,3,Formosa,27716,0,27716,0.0038,-3.77,-0.13,2016-07-01
2016,3,Jujuy,42537,1,42538,0.0059,3.28,7.55,2016-07-01
2016,3,La Pampa,69903,461,70364,0.0098,2.14,7.47,2016-07-01
2016,3,La Rioja,16912,18,16930,0.0023,1.16,0.95,2016-07-01
2016,3,Mendoza,169174,1450,170624,0.0237,-0.12,-0.12,2016-07-01
2016,3,Misiones,97997,0,97997,0.0136,2.28,6.96,2016-07-01
2016,3,Neuquén,110491,2112,112603,0.0156,1.89,11.91,2016-07-01
2016,3,Río Negro,100024,1002,101026,0.0140,0.32,1.42,2016-07-01
2016,3,Salta,107790,1,107791,0.0150,2.72,7.18,2016-07-01
2016,3,San Juan,51348,620,51968,0.0072,-0.09,-0.12,2016-07-01
2016,3,San Luis,12978,315,13293,0.0018,0.28,0.56,2016-07-01
2016,3,Santa Cruz,25886,371,26257,0.0036,0.40,-0.05,2016-07-01
2016,3,Santa Fe,566625,386,567011,0.0787,0.45,1.85,2016-07-01
2016,3,Santiago Del Estero,35658,2,35660,0.0049,-3.52,-9.49,2016-07-01
2016,3,Tierra Del Fuego,31306,619,31925,0.0044,1.80,-5.37,2016-07-01
2016,3,Tucumán,151282,37,151319,0.0210,1.78,4.85,2016-07-01
2016,4,Buenos Aires,3131499,11202,3142701,0.4334,1.82,6.19,2016-10-01
2016,4,Capital Federal,1393443,8016,1401459,0.1933,-0.12,2.28,2016-10-01
2016,4,Catamarca,27021,13,27034,0.0037,0.24,2.12,2016-10-01
2016,4,Chaco,88833,14,88847,0.0123,-0.43,2.65,2016-10-01
2016,4,Chubut,62035,1730,63765,0.0088,-0.29,-0.40,2016-10-01
2016,4,Corrientes,88084,12,88096,0.0121,-0.28,3.11,2016-10-01
2016,4,Córdoba,636422,133,636555,0.0878,-0.94,1.67,2016-10-01
2016,4,Entre Ríos,180188,57,180245,0.0249,-0.50,3.51,2016-10-01
2016,4,Formosa,29513,0,29513,0.0041,6.48,5.07,2016-10-01
2016,4,Jujuy,42624,1,42625,0.0059,0.20,6.77,2016-10-01
2016,4,La Pampa,71368,460,71828,0.0099,2.08,8.23,2016-10-01
2016,4,La Rioja,16298,18,16316,0.0022,-3.63,-3.64,2016-10-01
2016,4,Mendoza,169274,1451,170725,0.0235,0.06,-0.05,2016-10-01
2016,4,Misiones,97390,0,97390,0.0134,-0.62,4.89,2016-10-01
2016,4,Neuquén,111723,2112,113835,0.0157,1.09,5.98,2016-10-01
2016,4,Río Negro,100020,1000,101020,0.0139,-0.01,1.30,2016-10-01
2016,4,Salta,106934,1,106935,0.0147,-0.79,4.92,2016-10-01
2016,4,San Juan,51301,620,51921,0.0072,-0.09,-0.21,2016-10-01
2016,4,San Luis,12992,315,13307,0.0018,0.11,0.67,2016-10-01
2016,4,Santa Cruz,26094,370,26464,0.0036,0.79,0.23,2016-10-01
2016,4,Santa Fe,561470,362,561832,0.0775,-0.91,0.03,2016-10-01
2016,4,Santiago Del Estero,35049,2,35051,0.0048,-1.71,-10.44,2016-10-01
2016,4,Tierra Del Fuego,31938,619,32557,0.0045,1.98,8.69,2016-10-01
2016,4,Tucumán,151615,37,151652,0.0209,0.22,3.80,2016-10-01
2017,1,Buenos Aires,3178174,11202,3189376,0.4366,1.49,8.39,2017-01-01
2017,1,Capital Federal,1391030,8016,1399046,0.1915,-0.17,4.57,2017-01-01
2017,1,Catamarca,26304,13,26317,0.0036,-2.65,-0.27,2017-01-01
2017,1,Chaco,89036,14,89050,0.0122,0.23,2.77,2017-01-01
2017,1,Chubut,62166,1730,63896,0.0087,0.21,0.15,2017-01-01
2017,1,Corrientes,88596,12,88608,0.0121,0.58,3.59,2017-01-01
2017,1,Córdoba,641066,133,641199,0.0878,0.73,5.13,2017-01-01
2017,1,Entre Ríos,180296,57,180353,0.0247,0.06,3.17,2017-01-01
2017,1,Formosa,29705,0,29705,0.0041,0.65,4.91,2017-01-01
2017,1,Jujuy,43202,1,43203,0.0059,1.36,7.23,2017-01-01
2017,1,La Pampa,71458,455,71913,0.0098,0.12,9.08,2017-01-01
2017,1,La Rioja,16207,18,16225,0.0022,-0.56,-2.79,2017-01-01
2017,1,Mendoza,169282,1451,170733,0.0234,0.00,-0.05,2017-01-01
2017,1,Misiones,97619,0,97619,0.0134,0.24,5.01,2017-01-01
2017,1,Neuquén,113227,2112,115339,0.0158,1.32,10.63,2017-01-01
2017,1,Río Negro,100288,1000,101288,0.0139,0.27,1.47,2017-01-01
2017,1,Salta,107632,1,107633,0.0147,0.65,5.08,2017-01-01
2017,1,San Juan,51253,620,51873,0.0071,-0.09,-0.23,2017-01-01
2017,1,San Luis,12992,315,13307,0.0018,0.00,0.57,2017-01-01
2017,1,Santa Cruz,26116,370,26486,0.0036,0.08,0.76,2017-01-01
2017,1,Santa Fe,562520,362,562882,0.0770,0.19,1.97,2017-01-01
2017,1,Santiago Del Estero,34473,2,34475,0.0047,-1.64,-8.55,2017-01-01
2017,1,Tierra Del Fuego,31938,619,32557,0.0045,0.00,6.79,2017-01-01
2017,1,Tucumán,152734,37,152771,0.0209,0.74,4.18,2017-01-01
2017,2,Buenos Aires,3067430,11201,3078631,0.4144,-3.47,1.09,2017-04-01
2017,2,Capital Federal,1592175,8016,1600191,0.2154,14.38,14.74,2017-04-01
2017,2,Catamarca,26692,13,26705,0.0036,1.47,0.56,2017-04-01
2017,2,Chaco,90597,14,90611,0.0122,1.75,2.67,2017-04-01
2017,2,Chubut,62245,1730,63975,0.0086,0.12,0.19,2017-04-01
2017,2,Corrientes,90085,12,90097,0.0121,1.68,3.61,2017-04-01
2017,2,Córdoba,657505,133,657638,0.0885,2.56,3.58,2017-04-01
2017,2,Entre Ríos,182675,57,182732,0.0246,1.32,2.44,2017-04-01
2017,2,Formosa,29956,0,29956,0.0040,0.84,4.01,2017-04-01
2017,2,Jujuy,42656,1,42657,0.0057,-1.26,3.56,2017-04-01
2017,2,La Pampa,72573,449,73022,0.0098,1.54,6.00,2017-04-01
2017,2,La Rioja,16271,18,16289,0.0022,0.39,-2.67,2017-04-01
2017,2,Mendoza,169302,1451,170753,0.0230,0.01,-0.04,2017-04-01
2017,2,Misiones,99794,0,99794,0.0134,2.23,4.15,2017-04-01
2017,2,Neuquén,115321,2112,117433,0.0158,1.82,6.26,2017-04-01
2017,2,Río Negro,100621,998,101619,0.0137,0.33,0.91,2017-04-01
2017,2,Salta,108540,1,108541,0.0146,0.84,3.44,2017-04-01
2017,2,San Juan,51261,620,51881,0.0070,0.02,-0.25,2017-04-01
2017,2,San Luis,12992,315,13307,0.0018,0.00,0.38,2017-04-01
2017,2,Santa Cruz,26019,369,26388,0.0036,-0.37,0.90,2017-04-01
2017,2,Santa Fe,566918,362,567280,0.0764,0.78,0.50,2017-04-01
2017,2,Santiago Del Estero,33194,2,33196,0.0045,-3.71,-10.19,2017-04-01
2017,2,Tierra Del Fuego,31938,619,32557,0.0044,0.00,3.82,2017-04-01
2017,2,Tucumán,154374,37,154411,0.0208,1.07,3.86,2017-04-01
2017,3,Buenos Aires,3046758,11202,3057960,0.3959,-0.67,-0.93,2017-07-01
2017,3,Capital Federal,1563289,7070,1570359,0.2033,-1.86,11.92,2017-07-01
2017,3,Catamarca,33467,11,33478,0.0043,25.36,24.13,2017-07-01
2017,3,Chaco,93747,12,93759,0.0121,3.47,5.08,2017-07-01
2017,3,Chubut,81067,2477,83544,0.0108,30.59,30.64,2017-07-01
2017,3,Corrientes,92536,12,92548,0.0120,2.72,4.76,2017-07-01
2017,3,Córdoba,696536,108,696644,0.0902,5.93,8.41,2017-07-01
2017,3,Entre Ríos,185414,50,185464,0.0240,1.50,2.38,2017-07-01
2017,3,Formosa,32105,0,32105,0.0042,7.17,15.84,2017-07-01
2017,3,Jujuy,43241,1,43242,0.0056,1.37,1.65,2017-07-01
2017,3,La Pampa,79280,410,79690,0.0103,9.13,13.25,2017-07-01
2017,3,La Rioja,51896,17,51913,0.0067,218.70,206.63,2017-07-01
2017,3,Mendoza,190958,1533,192491,0.0249,12.73,12.82,2017-07-01
2017,3,Misiones,100476,0,100476,0.0130,0.68,2.53,2017-07-01
2017,3,Neuquén,113755,2029,115784,0.0150,-1.40,2.82,2017-07-01
2017,3,Río Negro,106393,1103,107496,0.0139,5.78,6.40,2017-07-01
2017,3,Salta,132517,1,132518,0.0172,22.09,22.94,2017-07-01
2017,3,San Juan,61789,660,62449,0.0081,20.37,20.17,2017-07-01
2017,3,San Luis,21408,311,21719,0.0028,63.21,63.39,2017-07-01
2017,3,Santa Cruz,33222,468,33690,0.0044,27.67,28.31,2017-07-01
2017,3,Santa Fe,662086,256,662342,0.0857,16.76,16.81,2017-07-01
2017,3,Santiago Del Estero,82792,2,82794,0.0107,149.41,132.18,2017-07-01
2017,3,Tierra Del Fuego,30883,583,31466,0.0041,-3.35,-1.44,2017-07-01
2017,3,Tucumán,160979,33,161012,0.0208,4.27,6.41,2017-07-01
2017,4,Buenos Aires,3171206,10690,3181896,0.4043,4.05,1.25,2017-10-01
2017,4,Capital Federal,1575418,6906,1582324,0.2011,0.76,12.91,2017-10-01
2017,4,Catamarca,29548,10,29558,0.0038,-11.71,9.34,2017-10-01
2017,4,Chaco,96603,12,96615,0.0123,3.05,8.74,2017-10-01
2017,4,Chubut,91012,2428,93440,0.0119,11.85,46.54,2017-10-01
2017,4,Corrientes,93760,11,93771,0.0119,1.32,6.44,2017-10-01
2017,4,Córdoba,709874,105,709979,0.0902,1.91,11.53,2017-10-01
2017,4,Entre Ríos,193654,49,193703,0.0246,4.44,7.47,2017-10-01
2017,4,Formosa,32056,0,32056,0.0041,-0.15,8.62,2017-10-01
2017,4,Jujuy,43551,1,43552,0.0055,0.72,2.17,2017-10-01
2017,4,La Pampa,81675,396,82071,0.0104,2.99,14.26,2017-10-01
2017,4,La Rioja,52177,17,52194,0.0066,0.54,219.89,2017-10-01
2017,4,Mendoza,178661,1490,180151,0.0229,-6.41,5.52,2017-10-01
2017,4,Misiones,103895,0,103895,0.0132,3.40,6.68,2017-10-01
2017,4,Neuquén,114965,2006,116971,0.0149,1.03,2.75,2017-10-01
2017,4,Río Negro,108702,1062,109764,0.0139,2.11,8.66,2017-10-01
2017,4,Salta,132811,1,132812,0.0169,0.22,24.20,2017-10-01
2017,4,San Juan,57965,659,58624,0.0074,-6.12,12.91,2017-10-01
2017,4,San Luis,14604,300,14904,0.0019,-31.38,12.00,2017-10-01
2017,4,Santa Cruz,29018,434,29452,0.0037,-12.58,11.29,2017-10-01
2017,4,Santa Fe,672137,323,672460,0.0854,1.53,19.69,2017-10-01
2017,4,Santiago Del Estero,68842,2,68844,0.0087,-16.85,96.41,2017-10-01
2017,4,Tierra Del Fuego,28346,508,28854,0.0037,-8.30,-11.37,2017-10-01
2017,4,Tucumán,162298,34,162332,0.0206,0.82,7.04,2017-10-01
2018,1,Buenos Aires,3464882,10564,3475446,0.4324,9.23,8.97,2018-01-01
2018,1,Capital Federal,1359882,6688,1366570,0.1700,-13.64,-2.32,2018-01-01
2018,1,Catamarca,33934,11,33945,0.0042,14.84,28.99,2018-01-01
2018,1,Chaco,96925,12,96937,0.0121,0.33,8.86,2018-01-01
2018,1,Chubut,95532,2427,97959,0.0122,4.84,53.31,2018-01-01
2018,1,Corrientes,94406,11,94417,0.0117,0.69,6.56,2018-01-01
2018,1,Córdoba,713825,101,713926,0.0888,0.56,11.34,2018-01-01
2018,1,Entre Ríos,197346,48,197394,0.0246,1.91,9.45,2018-01-01
2018,1,Formosa,32328,0,32328,0.0040,0.85,8.83,2018-01-01
2018,1,Jujuy,44405,1,44406,0.0055,1.96,2.78,2018-01-01
2018,1,La Pampa,82668,396,83064,0.0103,1.21,15.51,2018-01-01
2018,1,La Rioja,52228,17,52245,0.0065,0.10,222.00,2018-01-01
2018,1,Mendoza,199463,1484,200947,0.0250,11.54,17.70,2018-01-01
2018,1,Misiones,103580,0,103580,0.0129,-0.30,6.11,2018-01-01
2018,1,Neuquén,115897,2006,117903,0.0147,0.80,2.22,2018-01-01
2018,1,Río Negro,110057,1062,111119,0.0138,1.23,9.71,2018-01-01
2018,1,Salta,133182,1,133183,0.0166,0.28,23.74,2018-01-01
2018,1,San Juan,62610,658,63268,0.0079,7.92,21.97,2018-01-01
2018,1,San Luis,21096,300,21396,0.0027,43.56,60.79,2018-01-01
2018,1,Santa Cruz,33970,435,34405,0.0043,16.82,29.90,2018-01-01
2018,1,Santa Fe,679717,309,680026,0.0846,1.13,20.81,2018-01-01
2018,1,Santiago Del Estero,82916,2,82918,0.0103,20.44,140.52,2018-01-01
2018,1,Tierra Del Fuego,31106,508,31614,0.0039,9.57,-2.90,2018-01-01
2018,1,Tucumán,168026,31,168057,0.0209,3.53,10.01,2018-01-01
2018,2,Buenos Aires,3490134,10565,3500699,0.4316,0.73,13.71,2018-04-01
2018,2,Capital Federal,1362498,6688,1369186,0.1688,0.19,-14.44,2018-04-01
2018,2,Catamarca,34078,11,34089,0.0042,0.42,27.65,2018-04-01
2018,2,Chaco,98509,12,98521,0.0121,1.63,8.73,2018-04-01
2018,2,Chubut,98137,2427,100564,0.0124,2.66,57.19,2018-04-01
2018,2,Corrientes,97946,11,97957,0.0121,3.75,8.72,2018-04-01
2018,2,Córdoba,712979,94,713073,0.0879,-0.12,8.43,2018-04-01
2018,2,Entre Ríos,199937,48,199985,0.0247,1.31,9.44,2018-04-01
2018,2,Formosa,44554,0,44554,0.0055,37.82,48.73,2018-04-01
2018,2,Jujuy,45132,1,45133,0.0056,1.64,5.80,2018-04-01
2018,2,La Pampa,82177,244,82421,0.0102,-0.77,12.87,2018-04-01
2018,2,La Rioja,51931,17,51948,0.0064,-0.57,218.91,2018-04-01
2018,2,Mendoza,199468,1484,200952,0.0248,0.00,17.69,2018-04-01
2018,2,Misiones,106147,0,106147,0.0131,2.48,6.37,2018-04-01
2018,2,Neuquén,113842,2006,115848,0.0143,-1.74,-1.35,2018-04-01
2018,2,Río Negro,111176,1059,112235,0.0138,1.00,10.45,2018-04-01
2018,2,Salta,134166,1,134167,0.0165,0.74,23.61,2018-04-01
2018,2,San Juan,63443,658,64101,0.0079,1.32,23.55,2018-04-01
2018,2,San Luis,21168,300,21468,0.0026,0.34,61.33,2018-04-01
2018,2,Santa Cruz,33970,435,34405,0.0042,0.00,30.38,2018-04-01
2018,2,Santa Fe,684243,309,684552,0.0844,0.67,20.67,2018-04-01
2018,2,Santiago Del Estero,83773,2,83775,0.0103,1.03,152.36,2018-04-01
2018,2,Tierra Del Fuego,44199,508,44707,0.0055,41.42,37.32,2018-04-01
2018,2,Tucumán,169926,31,169957,0.0210,1.13,10.07,2018-04-01
2018,3,Buenos Aires,3599714,10563,3610277,0.4325,3.13,18.06,2018-07-01
2018,3,Capital Federal,1385804,6686,1392490,0.1668,1.70,-11.33,2018-07-01
2018,3,Catamarca,34215,11,34226,0.0041,0.40,2.23,2018-07-01
2018,3,Chaco,102021,12,102033,0.0122,3.56,8.82,2018-07-01
2018,3,Chubut,101310,2426,103736,0.0124,3.15,24.17,2018-07-01
2018,3,Corrientes,99445,11,99456,0.0119,1.53,7.46,2018-07-01
2018,3,Córdoba,725764,94,725858,0.0870,1.79,4.19,2018-07-01
2018,3,Entre Ríos,204560,48,204608,0.0245,2.31,10.32,2018-07-01
2018,3,Formosa,44865,0,44865,0.0054,0.70,39.74,2018-07-01
2018,3,Jujuy,44934,1,44935,0.0054,-0.44,3.92,2018-07-01
2018,3,La Pampa,83180,244,83424,0.0100,1.22,4.69,2018-07-01
2018,3,La Rioja,51855,17,51872,0.0062,-0.15,-0.08,2018-07-01
2018,3,Mendoza,205545,1484,207029,0.0248,3.02,7.55,2018-07-01
2018,3,Misiones,108042,0,108042,0.0129,1.79,7.53,2018-07-01
2018,3,Neuquén,114713,2005,116718,0.0140,0.75,0.81,2018-07-01
2018,3,Río Negro,112433,1059,113492,0.0136,1.12,5.58,2018-07-01
2018,3,Salta,132882,1,132883,0.0159,-0.96,0.28,2018-07-01
2018,3,San Juan,63823,658,64481,0.0077,0.59,3.25,2018-07-01
2018,3,San Luis,74121,300,74421,0.0089,246.66,242.65,2018-07-01
2018,3,Santa Cruz,33565,434,33999,0.0041,-1.18,0.92,2018-07-01
2018,3,Santa Fe,694883,217,695100,0.0833,1.54,4.95,2018-07-01
2018,3,Santiago Del Estero,86358,2,86360,0.0103,3.09,4.31,2018-07-01
2018,3,Tierra Del Fuego,45056,508,45564,0.0055,1.92,44.80,2018-07-01
2018,3,Tucumán,171135,31,171166,0.0205,0.71,6.31,2018-07-01
2018,4,Buenos Aires,3626502,10104,3636606,0.4292,0.73,14.29,2018-10-01
2018,4,Capital Federal,1385577,3443,1389020,0.1639,-0.25,-12.22,2018-10-01
2018,4,Catamarca,33574,9,33583,0.0040,-1.88,13.62,2018-10-01
2018,4,Chaco,103257,13,103270,0.0122,1.21,6.89,2018-10-01
2018,4,Chubut,77204,1518,78722,0.0093,-24.11,-15.75,2018-10-01
2018,4,Corrientes,100591,10,100601,0.0119,1.15,7.28,2018-10-01
2018,4,Córdoba,737234,105,737339,0.0870,1.58,3.85,2018-10-01
2018,4,Entre Ríos,222003,44,222047,0.0262,8.52,14.63,2018-10-01
2018,4,Formosa,45204,0,45204,0.0053,0.76,41.02,2018-10-01
2018,4,Jujuy,90132,1,90133,0.0106,100.59,106.95,2018-10-01
2018,4,La Pampa,85368,268,85636,0.0101,2.65,4.34,2018-10-01
2018,4,La Rioja,51633,18,51651,0.0061,-0.43,-1.04,2018-10-01
2018,4,Mendoza,204982,1322,206304,0.0243,-0.35,14.52,2018-10-01
2018,4,Misiones,116273,0,116273,0.0137,7.62,11.91,2018-10-01
2018,4,Neuquén,112309,2056,114365,0.0135,-2.02,-2.23,2018-10-01
2018,4,Río Negro,115922,915,116837,0.0138,2.95,6.44,2018-10-01
2018,4,Salta,134577,1,134578,0.0159,1.28,1.33,2018-10-01
2018,4,San Juan,61834,564,62398,0.0074,-3.23,6.44,2018-10-01
2018,4,San Luis,96040,291,96331,0.0114,29.44,546.34,2018-10-01
2018,4,Santa Cruz,24443,325,24768,0.0029,-27.15,-15.90,2018-10-01
2018,4,Santa Fe,720161,229,720390,0.0850,3.64,7.13,2018-10-01
2018,4,Santiago Del Estero,89333,2,89335,0.0105,3.44,29.76,2018-10-01
2018,4,Tierra Del Fuego,45716,544,46260,0.0055,1.53,60.32,2018-10-01
2018,4,Tucumán,171972,32,172004,0.0203,0.49,5.96,2018-10-01
2019,1,Buenos Aires,3736563,10104,3746667,0.4332,3.03,7.80,2019-01-01
2019,1,Capital Federal,1396157,3443,1399600,0.1618,0.76,2.42,2019-01-01
2019,1,Catamarca,33613,9,33622,0.0039,0.12,-0.95,2019-01-01
2019,1,Chaco,103664,13,103677,0.0120,0.39,6.95,2019-01-01
2019,1,Chubut,78260,1518,79778,0.0092,1.34,-18.56,2019-01-01
2019,1,Corrientes,102477,10,102487,0.0119,1.87,8.55,2019-01-01
2019,1,Córdoba,744010,105,744115,0.0860,0.92,4.23,2019-01-01
2019,1,Entre Ríos,232403,44,232447,0.0269,4.68,17.76,2019-01-01
2019,1,Formosa,45211,0,45211,0.0052,0.02,39.85,2019-01-01
2019,1,Jujuy,90146,1,90147,0.0104,0.02,103.01,2019-01-01
2019,1,La Pampa,88892,268,89160,0.0103,4.12,7.34,2019-01-01
2019,1,La Rioja,51638,18,51656,0.0060,0.01,-1.13,2019-01-01
2019,1,Mendoza,204976,1322,206298,0.0239,-0.00,2.66,2019-01-01
2019,1,Misiones,122720,0,122720,0.0142,5.54,18.48,2019-01-01
2019,1,Neuquén,112321,2056,114377,0.0132,0.01,-2.99,2019-01-01
2019,1,Río Negro,120173,915,121088,0.0140,3.64,8.97,2019-01-01
2019,1,Salta,136019,1,136020,0.0157,1.07,2.13,2019-01-01
2019,1,San Juan,61881,564,62445,0.0072,0.08,-1.30,2019-01-01
2019,1,San Luis,96044,291,96335,0.0111,0.00,350.25,2019-01-01
2019,1,Santa Cruz,24580,325,24905,0.0029,0.55,-27.61,2019-01-01
2019,1,Santa Fe,736851,227,737078,0.0852,2.32,8.39,2019-01-01
2019,1,Santiago Del Estero,89851,2,89853,0.0104,0.58,8.36,2019-01-01
2019,1,Tierra Del Fuego,45903,544,46447,0.0054,0.40,46.92,2019-01-01
2019,1,Tucumán,171970,32,172002,0.0199,-0.00,2.35,2019-01-01
2019,2,Buenos Aires,3845594,10104,3855698,0.4303,2.91,10.14,2019-04-01
2019,2,Capital Federal,1412177,3443,1415620,0.1580,1.14,3.39,2019-04-01
2019,2,Catamarca,33626,9,33635,0.0038,0.04,-1.33,2019-04-01
2019,2,Chaco,108721,13,108734,0.0121,4.88,10.37,2019-04-01
2019,2,Chubut,86038,1518,87556,0.0098,9.75,-12.94,2019-04-01
2019,2,Corrientes,111539,10,111549,0.0124,8.84,13.88,2019-04-01
2019,2,Córdoba,775023,105,775128,0.0865,4.17,8.70,2019-04-01
2019,2,Entre Ríos,235780,44,235824,0.0263,1.45,17.92,2019-04-01
2019,2,Formosa,46438,0,46438,0.0052,2.71,4.23,2019-04-01
2019,2,Jujuy,86706,1,86707,0.0097,-3.82,92.11,2019-04-01
2019,2,La Pampa,89937,268,90205,0.0101,1.17,9.44,2019-04-01
2019,2,La Rioja,50283,18,50301,0.0056,-2.62,-3.17,2019-04-01
2019,2,Mendoza,222535,1322,223857,0.0250,8.51,11.40,2019-04-01
2019,2,Misiones,132878,0,132878,0.0148,8.28,25.18,2019-04-01
2019,2,Neuquén,120954,1999,122953,0.0137,7.50,6.13,2019-04-01
2019,2,Río Negro,137632,915,138547,0.0155,14.42,23.44,2019-04-01
2019,2,Salta,142567,1,142568,0.0159,4.81,6.26,2019-04-01
2019,2,San Juan,69461,564,70025,0.0078,12.14,9.24,2019-04-01
2019,2,San Luis,117094,291,117385,0.0131,21.85,446.79,2019-04-01
2019,2,Santa Cruz,30225,325,30550,0.0034,22.67,-11.20,2019-04-01
2019,2,Santa Fe,743258,226,743484,0.0830,0.87,8.61,2019-04-01
2019,2,Santiago Del Estero,126752,2,126754,0.0141,41.07,51.30,2019-04-01
2019,2,Tierra Del Fuego,46910,544,47454,0.0053,2.17,6.14,2019-04-01
2019,2,Tucumán,166299,32,166331,0.0186,-3.30,-2.13,2019-04-01
2019,3,Buenos Aires,3950114,10119,3960233,0.4321,2.71,9.69,2019-07-01
2019,3,Capital Federal,1437734,3477,1441211,0.1573,1.81,3.50,2019-07-01
2019,3,Catamarca,32391,9,32400,0.0035,-3.67,-5.34,2019-07-01
2019,3,Chaco,114438,13,114451,0.0125,5.26,12.17,2019-07-01
2019,3,Chubut,87481,1524,89005,0.0097,1.65,-14.20,2019-07-01
2019,3,Corrientes,112749,10,112759,0.0123,1.08,13.38,2019-07-01
2019,3,Córdoba,782946,107,783053,0.0854,1.02,7.88,2019-07-01
2019,3,Entre Ríos,238057,45,238102,0.0260,0.97,16.37,2019-07-01
2019,3,Formosa,46066,0,46066,0.0050,-0.80,2.68,2019-07-01
2019,3,Jujuy,86575,1,86576,0.0094,-0.15,92.67,2019-07-01
2019,3,La Pampa,90559,269,90828,0.0099,0.69,8.88,2019-07-01
2019,3,La Rioja,49659,18,49677,0.0054,-1.24,-4.23,2019-07-01
2019,3,Mendoza,223015,1322,224337,0.0245,0.21,8.36,2019-07-01
2019,3,Misiones,133883,0,133883,0.0146,0.76,23.92,2019-07-01
2019,3,Neuquén,123435,1986,125421,0.0137,2.01,7.46,2019-07-01
2019,3,Río Negro,143391,904,144295,0.0157,4.15,27.14,2019-07-01
2019,3,Salta,151834,1,151835,0.0166,6.50,14.26,2019-07-01
2019,3,San Juan,72535,563,73098,0.0080,4.39,13.36,2019-07-01
2019,3,San Luis,122409,291,122700,0.0134,4.53,64.87,2019-07-01
2019,3,Santa Cruz,37642,328,37970,0.0041,24.29,11.68,2019-07-01
2019,3,Santa Fe,760706,228,760934,0.0830,2.35,9.47,2019-07-01
2019,3,Santiago Del Estero,133130,2,133132,0.0145,5.03,54.16,2019-07-01
2019,3,Tierra Del Fuego,48043,544,48587,0.0053,2.39,6.63,2019-07-01
2019,3,Tucumán,164099,32,164131,0.0179,-1.32,-4.11,2019-07-01
2019,4,Buenos Aires,3681120,5134,3686254,0.4192,-6.92,1.37,2019-10-01
2019,4,Capital Federal,1356695,1410,1358105,0.1544,-5.77,-2.23,2019-10-01
2019,4,Catamarca,38310,1,38311,0.0044,18.24,14.08,2019-10-01
2019,4,Chaco,117900,3,117903,0.0134,3.02,14.17,2019-10-01
2019,4,Chubut,95292,810,96102,0.0109,7.97,22.08,2019-10-01
2019,4,Corrientes,113831,3,113834,0.0129,0.95,13.15,2019-10-01
2019,4,Córdoba,806633,55,806688,0.0917,3.02,9.41,2019-10-01
2019,4,Entre Ríos,239017,13,239030,0.0272,0.39,7.65,2019-10-01
2019,4,Formosa,46711,0,46711,0.0053,1.40,3.33,2019-10-01
2019,4,Jujuy,88881,0,88881,0.0101,2.66,-1.39,2019-10-01
2019,4,La Pampa,90280,119,90399,0.0103,-0.47,5.56,2019-10-01
2019,4,La Rioja,48999,3,49002,0.0056,-1.36,-5.13,2019-10-01
2019,4,Mendoza,185157,623,185780,0.0211,-17.19,-9.95,2019-10-01
2019,4,Misiones,135813,0,135813,0.0154,1.44,16.81,2019-10-01
2019,4,Neuquén,116069,376,116445,0.0132,-7.16,1.82,2019-10-01
2019,4,Río Negro,126636,504,127140,0.0145,-11.89,8.82,2019-10-01
2019,4,Salta,172443,2,172445,0.0196,13.57,28.14,2019-10-01
2019,4,San Juan,64715,259,64974,0.0074,-11.11,4.13,2019-10-01
2019,4,San Luis,108053,148,108201,0.0123,-11.82,12.32,2019-10-01
2019,4,Santa Cruz,39170,200,39370,0.0045,3.69,58.96,2019-10-01
2019,4,Santa Fe,769019,150,769169,0.0875,1.08,6.77,2019-10-01
2019,4,Santiago Del Estero,103587,1,103588,0.0118,-22.19,15.95,2019-10-01
2019,4,Tierra Del Fuego,40101,291,40392,0.0046,-16.87,-12.68,2019-10-01
2019,4,Tucumán,198621,23,198644,0.0226,21.03,15.49,2019-10-01
2020,1,Buenos Aires,3702985,5066,3708051,0.4208,0.59,-1.03,2020-01-01
2020,1,Capital Federal,1352104,1390,1353494,0.1536,-0.34,-3.29,2020-01-01
2020,1,Catamarca,39634,1,39635,0.0045,3.46,17.88,2020-01-01
2020,1,Chaco,120274,3,120277,0.0136,2.01,16.01,2020-01-01
2020,1,Chubut,95938,800,96738,0.0110,0.66,21.26,2020-01-01
2020,1,Corrientes,113967,3,113970,0.0129,0.12,11.20,2020-01-01
2020,1,Córdoba,811044,55,811099,0.0920,0.55,9.00,2020-01-01
2020,1,Entre Ríos,231833,13,231846,0.0263,-3.01,-0.26,2020-01-01
2020,1,Formosa,46434,0,46434,0.0053,-0.59,2.71,2020-01-01
2020,1,Jujuy,91665,0,91665,0.0104,3.13,1.68,2020-01-01
2020,1,La Pampa,89110,116,89226,0.0101,-1.30,0.07,2020-01-01
2020,1,La Rioja,48337,3,48340,0.0055,-1.35,-6.42,2020-01-01
2020,1,Mendoza,182837,615,183452,0.0208,-1.25,-11.07,2020-01-01
2020,1,Misiones,133552,0,133552,0.0152,-1.66,8.83,2020-01-01
2020,1,Neuquén,121354,373,121727,0.0138,4.54,6.43,2020-01-01
2020,1,Río Negro,125699,501,126200,0.0143,-0.74,4.22,2020-01-01
2020,1,Salta,170379,2,170381,0.0193,-1.20,25.26,2020-01-01
2020,1,San Juan,63975,256,64231,0.0073,-1.14,2.86,2020-01-01
2020,1,San Luis,110404,148,110552,0.0125,2.17,14.76,2020-01-01
2020,1,Santa Cruz,38625,197,38822,0.0044,-1.39,55.88,2020-01-01
2020,1,Santa Fe,770981,137,771118,0.0875,0.25,4.62,2020-01-01
2020,1,Santiago Del Estero,102754,1,102755,0.0117,-0.80,14.36,2020-01-01
2020,1,Tierra Del Fuego,38505,289,38794,0.0044,-3.96,-16.48,2020-01-01
2020,1,Tucumán,200045,22,200067,0.0227,0.72,16.32,2020-01-01
2020,2,Buenos Aires,3772480,5066,3777546,0.4183,1.87,-2.03,2020-04-01
2020,2,Capital Federal,1356431,1390,1357821,0.1504,0.32,-4.08,2020-04-01
2020,2,Catamarca,47975,1,47976,0.0053,21.04,42.64,2020-04-01
2020,2,Chaco,128129,3,128132,0.0142,6.53,17.84,2020-04-01
2020,2,Chubut,107831,825,108656,0.0120,12.32,24.10,2020-04-01
2020,2,Corrientes,118863,3,118866,0.0132,4.30,6.56,2020-04-01
2020,2,Córdoba,836413,55,836468,0.0926,3.13,7.91,2020-04-01
2020,2,Entre Ríos,234100,13,234113,0.0259,0.98,-0.73,2020-04-01
2020,2,Formosa,47932,0,47932,0.0053,3.23,3.22,2020-04-01
2020,2,Jujuy,94316,0,94316,0.0104,2.89,8.78,2020-04-01
2020,2,La Pampa,89693,116,89809,0.0099,0.65,-0.44,2020-04-01
2020,2,La Rioja,52152,3,52155,0.0058,7.89,3.69,2020-04-01
2020,2,Mendoza,200569,615,201184,0.0223,9.67,-10.13,2020-04-01
2020,2,Misiones,140340,0,140340,0.0155,5.08,5.62,2020-04-01
2020,2,Neuquén,125799,373,126172,0.0140,3.65,2.62,2020-04-01
2020,2,Río Negro,128985,501,129486,0.0143,2.60,-6.54,2020-04-01
2020,2,Salta,177760,2,177762,0.0197,4.33,24.69,2020-04-01
2020,2,San Juan,69521,256,69777,0.0077,8.63,-0.35,2020-04-01
2020,2,San Luis,113804,148,113952,0.0126,3.08,-2.92,2020-04-01
2020,2,Santa Cruz,38672,197,38869,0.0043,0.12,27.23,2020-04-01
2020,2,Santa Fe,777795,137,777932,0.0861,0.88,4.63,2020-04-01
2020,2,Santiago Del Estero,105446,1,105447,0.0117,2.62,-16.81,2020-04-01
2020,2,Tierra Del Fuego,38900,289,39189,0.0043,1.02,-17.42,2020-04-01
2020,2,Tucumán,217134,22,217156,0.0240,8.54,30.56,2020-04-01
2020,3,Buenos Aires,3932211,5066,3937277,0.4208,4.23,-0.58,2020-07-01
2020,3,Capital Federal,1371285,1390,1372675,0.1467,1.09,-4.76,2020-07-01
2020,3,Catamarca,49903,1,49904,0.0053,4.02,54.02,2020-07-01
2020,3,Chaco,133951,3,133954,0.0143,4.54,17.04,2020-07-01
2020,3,Chubut,129202,825,130027,0.0139,19.67,46.09,2020-07-01
2020,3,Corrientes,123388,3,123391,0.0132,3.81,9.43,2020-07-01
2020,3,Córdoba,867417,55,867472,0.0927,3.71,10.78,2020-07-01
2020,3,Entre Ríos,241482,13,241495,0.0258,3.15,1.43,2020-07-01
2020,3,Formosa,49209,0,49209,0.0053,2.66,6.82,2020-07-01
2020,3,Jujuy,106728,0,106728,0.0114,13.16,23.28,2020-07-01
2020,3,La Pampa,93619,116,93735,0.0100,4.37,3.20,2020-07-01
2020,3,La Rioja,52613,3,52616,0.0056,0.88,5.92,2020-07-01
2020,3,Mendoza,207173,615,207788,0.0222,3.28,-7.38,2020-07-01
2020,3,Misiones,143186,0,143186,0.0153,2.03,6.95,2020-07-01
2020,3,Neuquén,128862,373,129235,0.0138,2.43,3.04,2020-07-01
2020,3,Río Negro,130966,501,131467,0.0141,1.53,-8.89,2020-07-01
2020,3,Salta,180844,2,180846,0.0193,1.73,19.11,2020-07-01
2020,3,San Juan,77071,256,77327,0.0083,10.82,5.79,2020-07-01
2020,3,San Luis,116417,148,116565,0.0125,2.29,-5.00,2020-07-01
2020,3,Santa Cruz,39084,197,39281,0.0042,1.06,3.45,2020-07-01
2020,3,Santa Fe,802861,137,802998,0.0858,3.22,5.53,2020-07-01
2020,3,Santiago Del Estero,105491,1,105492,0.0113,0.04,-20.76,2020-07-01
2020,3,Tierra Del Fuego,39366,289,39655,0.0042,1.19,-18.38,2020-07-01
2020,3,Tucumán,223854,22,223876,0.0239,3.09,36.40,2020-07-01
2020,4,Buenos Aires,4028195,5066,4033261,0.4214,2.44,9.41,2020-10-01
2020,4,Capital Federal,1378140,1390,1379530,0.1441,0.50,1.58,2020-10-01
2020,4,Catamarca,52395,1,52396,0.0055,4.99,36.76,2020-10-01
2020,4,Chaco,139088,3,139091,0.0145,3.83,17.97,2020-10-01
2020,4,Chubut,129749,825,130574,0.0136,0.42,35.87,2020-10-01
2020,4,Corrientes,125656,3,125659,0.0131,1.84,10.39,2020-10-01
2020,4,Córdoba,902646,55,902701,0.0943,4.06,11.90,2020-10-01
2020,4,Entre Ríos,247368,13,247381,0.0258,2.44,3.49,2020-10-01
2020,4,Formosa,50206,0,50206,0.0052,2.03,7.48,2020-10-01
2020,4,Jujuy,105851,0,105851,0.0111,-0.82,19.09,2020-10-01
2020,4,La Pampa,96779,116,96895,0.0101,3.37,7.19,2020-10-01
2020,4,La Rioja,52775,3,52778,0.0055,0.31,7.71,2020-10-01
2020,4,Mendoza,214838,615,215453,0.0225,3.69,15.97,2020-10-01
2020,4,Misiones,147161,0,147161,0.0154,2.78,8.36,2020-10-01
2020,4,Neuquén,132762,373,133135,0.0139,3.02,14.33,2020-10-01
2020,4,Río Negro,140709,501,141210,0.0148,7.41,11.07,2020-10-01
2020,4,Salta,187388,2,187390,0.0196,3.62,8.67,2020-10-01
2020,4,San Juan,72340,256,72596,0.0076,-6.12,11.73,2020-10-01
2020,4,San Luis,119287,148,119435,0.0125,2.46,10.38,2020-10-01
2020,4,Santa Cruz,40477,197,40674,0.0042,3.55,3.31,2020-10-01
2020,4,Santa Fe,820676,137,820813,0.0858,2.22,6.71,2020-10-01
2020,4,Santiago Del Estero,106668,1,106669,0.0111,1.12,2.97,2020-10-01
2020,4,Tierra Del Fuego,39325,289,39614,0.0041,-0.10,-1.93,2020-10-01
2020,4,Tucumán,231067,22,231089,0.0241,3.22,16.33,2020-10-01
2021,1,Buenos Aires,4054936,5066,4060002,0.4208,0.66,9.49,2021-01-01
2021,1,Capital Federal,1378283,1390,1379673,0.1430,0.01,1.93,2021-01-01
2021,1,Catamarca,51967,1,51968,0.0054,-0.82,31.12,2021-01-01
2021,1,Chaco,139767,3,139770,0.0145,0.49,16.21,2021-01-01
2021,1,Chubut,131515,825,132340,0.0137,1.35,36.80,2021-01-01
2021,1,Corrientes,126622,3,126625,0.0131,0.77,11.10,2021-01-01
2021,1,Córdoba,910826,55,910881,0.0944,0.91,12.30,2021-01-01
2021,1,Entre Ríos,251950,13,251963,0.0261,1.85,8.68,2021-01-01
2021,1,Formosa,50686,0,50686,0.0053,0.96,9.16,2021-01-01
2021,1,Jujuy,110456,0,110456,0.0114,4.35,20.50,2021-01-01
2021,1,La Pampa,96989,116,97105,0.0101,0.22,8.83,2021-01-01
2021,1,La Rioja,52625,3,52628,0.0055,-0.28,8.87,2021-01-01
2021,1,Mendoza,218308,615,218923,0.0227,1.61,19.34,2021-01-01
2021,1,Misiones,149387,0,149387,0.0155,1.51,11.86,2021-01-01
2021,1,Neuquén,132862,373,133235,0.0138,0.08,9.45,2021-01-01
2021,1,Río Negro,140667,501,141168,0.0146,-0.03,11.86,2021-01-01
2021,1,Salta,187572,2,187574,0.0194,0.10,10.09,2021-01-01
2021,1,San Juan,78011,256,78267,0.0081,7.81,21.85,2021-01-01
2021,1,San Luis,119006,148,119154,0.0124,-0.24,7.78,2021-01-01
2021,1,Santa Cruz,45868,197,46065,0.0048,13.25,18.66,2021-01-01
2021,1,Santa Fe,825990,137,826127,0.0856,0.65,7.13,2021-01-01
2021,1,Santiago Del Estero,111640,1,111641,0.0116,4.66,8.65,2021-01-01
2021,1,Tierra Del Fuego,40133,289,40422,0.0042,2.04,4.20,2021-01-01
2021,1,Tucumán,231890,22,231912,0.0240,0.36,15.92,2021-01-01
2021,2,Buenos Aires,4127167,5184,4132351,0.4190,1.78,9.39,2021-04-01
2021,2,Capital Federal,1398747,1608,1400355,0.1420,1.50,3.13,2021-04-01
2021,2,Catamarca,55743,1,55744,0.0057,7.27,16.19,2021-04-01
2021,2,Chaco,140726,3,140729,0.0143,0.69,9.83,2021-04-01
2021,2,Chubut,138412,825,139237,0.0141,5.21,28.14,2021-04-01
2021,2,Corrientes,129498,3,129501,0.0131,2.27,8.95,2021-04-01
2021,2,Córdoba,930818,62,930880,0.0944,2.20,11.29,2021-04-01
2021,2,Entre Ríos,257617,15,257632,0.0261,2.25,10.05,2021-04-01
2021,2,Formosa,51551,0,51551,0.0052,1.71,7.55,2021-04-01
2021,2,Jujuy,111848,0,111848,0.0113,1.26,18.59,2021-04-01
2021,2,La Pampa,97551,116,97667,0.0099,0.58,8.75,2021-04-01
2021,2,La Rioja,81599,3,81602,0.0083,55.05,56.46,2021-04-01
2021,2,Mendoza,229052,619,229671,0.0233,4.91,14.16,2021-04-01
2021,2,Misiones,156176,0,156176,0.0158,4.54,11.28,2021-04-01
2021,2,Neuquén,137877,373,138250,0.0140,3.76,9.57,2021-04-01
2021,2,Río Negro,143583,501,144084,0.0146,2.07,11.27,2021-04-01
2021,2,Salta,191637,2,191639,0.0194,2.17,7.81,2021-04-01
2021,2,San Juan,78677,256,78933,0.0080,0.85,13.12,2021-04-01
2021,2,San Luis,122670,148,122818,0.0125,3.08,7.78,2021-04-01
2021,2,Santa Cruz,48785,197,48982,0.0050,6.33,26.02,2021-04-01
2021,2,Santa Fe,840449,151,840600,0.0852,1.75,8.06,2021-04-01
2021,2,Santiago Del Estero,114089,1,114090,0.0116,2.19,8.20,2021-04-01
2021,2,Tierra Del Fuego,35404,289,35693,0.0036,-11.70,-8.92,2021-04-01
2021,2,Tucumán,233026,25,233051,0.0236,0.49,7.32,2021-04-01
2021,3,Buenos Aires,4246425,5184,4251609,0.4216,2.89,7.98,2021-07-01
2021,3,Capital Federal,1411797,1608,1413405,0.1401,0.93,2.97,2021-07-01
2021,3,Catamarca,56253,1,56254,0.0056,0.91,12.72,2021-07-01
2021,3,Chaco,139868,3,139871,0.0139,-0.61,4.42,2021-07-01
2021,3,Chubut,155266,800,156066,0.0155,12.09,20.03,2021-07-01
2021,3,Corrientes,133816,3,133819,0.0133,3.33,8.45,2021-07-01
2021,3,Córdoba,946726,62,946788,0.0939,1.71,9.14,2021-07-01
2021,3,Entre Ríos,260360,15,260375,0.0258,1.06,7.82,2021-07-01
2021,3,Formosa,52795,0,52795,0.0052,2.41,7.29,2021-07-01
2021,3,Jujuy,111158,0,111158,0.0110,-0.62,4.15,2021-07-01
2021,3,La Pampa,100371,116,100487,0.0100,2.89,7.20,2021-07-01
2021,3,La Rioja,82157,3,82160,0.0081,0.68,56.15,2021-07-01
2021,3,Mendoza,255320,619,255939,0.0254,11.44,23.17,2021-07-01
2021,3,Misiones,158528,0,158528,0.0157,1.51,10.71,2021-07-01
2021,3,Neuquén,139436,373,139809,0.0139,1.13,8.18,2021-07-01
2021,3,Río Negro,144084,501,144585,0.0143,0.35,9.98,2021-07-01
2021,3,Salta,195831,2,195833,0.0194,2.19,8.29,2021-07-01
2021,3,San Juan,79227,256,79483,0.0079,0.70,2.79,2021-07-01
2021,3,San Luis,117716,148,117864,0.0117,-4.03,1.11,2021-07-01
2021,3,Santa Cruz,48779,197,48976,0.0049,-0.01,24.68,2021-07-01
2021,3,Santa Fe,841433,151,841584,0.0834,0.12,4.81,2021-07-01
2021,3,Santiago Del Estero,115457,1,115458,0.0114,1.20,9.45,2021-07-01
2021,3,Tierra Del Fuego,49934,289,50223,0.0050,40.71,26.65,2021-07-01
2021,3,Tucumán,232447,25,232472,0.0231,-0.25,3.84,2021-07-01
2021,4,Buenos Aires,4502772,6385,4509157,0.4299,6.06,11.80,2021-10-01
2021,4,Capital Federal,1409935,2184,1412119,0.1346,-0.09,2.36,2021-10-01
2021,4,Catamarca,59089,1,59090,0.0056,5.04,12.78,2021-10-01
2021,4,Chaco,143740,5,143745,0.0137,2.77,3.35,2021-10-01
2021,4,Chubut,159364,944,160308,0.0153,2.72,22.77,2021-10-01
2021,4,Corrientes,135908,4,135912,0.0130,1.56,8.16,2021-10-01
2021,4,Córdoba,986693,77,986770,0.0941,4.22,9.31,2021-10-01
2021,4,Entre Ríos,265024,22,265046,0.0253,1.79,7.14,2021-10-01
2021,4,Formosa,53663,0,53663,0.0051,1.64,6.89,2021-10-01
2021,4,Jujuy,113915,0,113915,0.0109,2.48,7.62,2021-10-01
2021,4,La Pampa,106834,173,107007,0.0102,6.49,10.44,2021-10-01
2021,4,La Rioja,83124,4,83128,0.0079,1.18,57.51,2021-10-01
2021,4,Mendoza,266783,804,267587,0.0255,4.55,24.20,2021-10-01
2021,4,Misiones,171132,0,171132,0.0163,7.95,16.29,2021-10-01
2021,4,Neuquén,146989,477,147466,0.0141,5.48,10.76,2021-10-01
2021,4,Río Negro,153189,564,153753,0.0147,6.34,8.88,2021-10-01
2021,4,Salta,199399,6,199405,0.0190,1.82,6.41,2021-10-01
2021,4,San Juan,79667,291,79958,0.0076,0.60,10.14,2021-10-01
2021,4,San Luis,118662,187,118849,0.0113,0.84,-0.49,2021-10-01
2021,4,Santa Cruz,48276,210,48486,0.0046,-1.00,19.21,2021-10-01
2021,4,Santa Fe,866265,176,866441,0.0826,2.95,5.56,2021-10-01
2021,4,Santiago Del Estero,115859,2,115861,0.0110,0.35,8.62,2021-10-01
2021,4,Tierra Del Fuego,52042,315,52357,0.0050,4.25,32.17,2021-10-01
2021,4,Tucumán,238609,30,238639,0.0227,2.65,3.27,2021-10-01
2022,1,Buenos Aires,4549131,6293,4555424,0.4288,1.03,12.20,2022-01-01
2022,1,Capital Federal,1415378,2163,1417541,0.1334,0.38,2.74,2022-01-01
2022,1,Catamarca,62377,1,62378,0.0059,5.56,20.03,2022-01-01
2022,1,Chaco,144114,5,144119,0.0136,0.26,3.11,2022-01-01
2022,1,Chubut,170701,927,171628,0.0162,7.06,29.69,2022-01-01
2022,1,Corrientes,142574,4,142578,0.0134,4.90,12.60,2022-01-01
2022,1,Córdoba,1003729,74,1003803,0.0945,1.73,10.20,2022-01-01
2022,1,Entre Ríos,267904,22,267926,0.0252,1.09,6.34,2022-01-01
2022,1,Formosa,54548,0,54548,0.0051,1.65,7.62,2022-01-01
2022,1,Jujuy,116509,0,116509,0.0110,2.28,5.48,2022-01-01
2022,1,La Pampa,109560,172,109732,0.0103,2.55,13.00,2022-01-01
2022,1,La Rioja,84299,4,84303,0.0079,1.41,60.19,2022-01-01
2022,1,Mendoza,274399,786,275185,0.0259,2.84,25.70,2022-01-01
2022,1,Misiones,171508,0,171508,0.0161,0.22,14.81,2022-01-01
2022,1,Neuquén,149208,471,149679,0.0141,1.50,12.34,2022-01-01
2022,1,Río Negro,156821,553,157374,0.0148,2.36,11.48,2022-01-01
2022,1,Salta,197510,5,197515,0.0186,-0.95,5.30,2022-01-01
2022,1,San Juan,87888,290,88178,0.0083,10.28,12.66,2022-01-01
2022,1,San Luis,119659,185,119844,0.0113,0.84,0.58,2022-01-01
2022,1,Santa Cruz,48898,204,49102,0.0046,1.27,6.59,2022-01-01
2022,1,Santa Fe,870364,115,870479,0.0819,0.47,5.37,2022-01-01
2022,1,Santiago Del Estero,116459,2,116461,0.0110,0.52,4.32,2022-01-01
2022,1,Tierra Del Fuego,52298,313,52611,0.0050,0.49,30.15,2022-01-01
2022,1,Tucumán,245554,30,245584,0.0231,2.91,5.90,2022-01-01
2022,2,Buenos Aires,4660984,6199,4667183,0.4259,2.45,12.94,2022-04-01
2022,2,Capital Federal,1534626,2145,1536771,0.1402,8.41,9.74,2022-04-01
2022,2,Catamarca,67007,1,67008,0.0061,7.42,20.21,2022-04-01
2022,2,Chaco,143559,5,143564,0.0131,-0.39,2.01,2022-04-01
2022,2,Chubut,161901,904,162805,0.0149,-5.14,16.93,2022-04-01
2022,2,Corrientes,144993,4,144997,0.0132,1.70,11.97,2022-04-01
2022,2,Córdoba,1026367,68,1026435,0.0937,2.25,10.27,2022-04-01
2022,2,Entre Ríos,269330,22,269352,0.0246,0.53,4.55,2022-04-01
2022,2,Formosa,67881,0,67881,0.0062,24.44,31.68,2022-04-01
2022,2,Jujuy,115314,0,115314,0.0105,-1.03,3.10,2022-04-01
2022,2,La Pampa,111356,171,111527,0.0102,1.64,14.19,2022-04-01
2022,2,La Rioja,86026,4,86030,0.0079,2.05,5.43,2022-04-01
2022,2,Mendoza,278785,777,279562,0.0255,1.59,21.72,2022-04-01
2022,2,Misiones,178813,0,178813,0.0163,4.26,14.49,2022-04-01
2022,2,Neuquén,161500,468,161968,0.0148,8.21,17.16,2022-04-01
2022,2,Río Negro,159216,548,159764,0.0146,1.52,10.88,2022-04-01
2022,2,Salta,203172,5,203177,0.0185,2.87,6.02,2022-04-01
2022,2,San Juan,100126,281,100407,0.0092,13.87,27.21,2022-04-01
2022,2,San Luis,121559,182,121741,0.0111,1.58,-0.88,2022-04-01
2022,2,Santa Cruz,48987,198,49185,0.0045,0.17,0.41,2022-04-01
2022,2,Santa Fe,878749,110,878859,0.0802,0.96,4.55,2022-04-01
2022,2,Santiago Del Estero,118042,2,118044,0.0108,1.36,3.47,2022-04-01
2022,2,Tierra Del Fuego,53458,312,53770,0.0049,2.20,50.65,2022-04-01
2022,2,Tucumán,254497,30,254527,0.0232,3.64,9.22,2022-04-01
2022,3,Buenos Aires,4715469,6199,4721668,0.4257,1.17,11.06,2022-07-01
2022,3,Capital Federal,1545534,2145,1547679,0.1395,0.71,9.50,2022-07-01
2022,3,Catamarca,70292,1,70293,0.0063,4.90,24.96,2022-07-01
2022,3,Chaco,144141,5,144146,0.0130,0.41,3.06,2022-07-01
2022,3,Chubut,164874,904,165778,0.0149,1.83,6.22,2022-07-01
2022,3,Corrientes,144842,4,144846,0.0131,-0.10,8.24,2022-07-01
2022,3,Córdoba,1038600,68,1038668,0.0936,1.19,9.70,2022-07-01
2022,3,Entre Ríos,268937,22,268959,0.0242,-0.15,3.30,2022-07-01
2022,3,Formosa,68537,1,68538,0.0062,0.97,29.82,2022-07-01
2022,3,Jujuy,118823,0,118823,0.0107,3.04,6.90,2022-07-01
2022,3,La Pampa,115921,171,116092,0.0105,4.09,15.53,2022-07-01
2022,3,La Rioja,86860,4,86864,0.0078,0.97,5.73,2022-07-01
2022,3,Mendoza,288746,777,289523,0.0261,3.56,13.12,2022-07-01
2022,3,Misiones,182157,0,182157,0.0164,1.87,14.91,2022-07-01
2022,3,Neuquén,162693,468,163161,0.0147,0.74,16.70,2022-07-01
2022,3,Río Negro,160010,548,160558,0.0145,0.50,11.05,2022-07-01
2022,3,Salta,204536,5,204541,0.0184,0.67,4.45,2022-07-01
2022,3,San Juan,103118,281,103399,0.0093,2.98,30.09,2022-07-01
2022,3,San Luis,121888,182,122070,0.0110,0.27,3.57,2022-07-01
2022,3,Santa Cruz,49312,198,49510,0.0045,0.66,1.09,2022-07-01
2022,3,Santa Fe,887700,110,887810,0.0800,1.02,5.49,2022-07-01
2022,3,Santiago Del Estero,119030,2,119032,0.0107,0.84,3.10,2022-07-01
2022,3,Tierra Del Fuego,53584,312,53896,0.0049,0.23,7.31,2022-07-01
2022,3,Tucumán,263087,30,263117,0.0237,3.37,13.18,2022-07-01
